[]
Annna	Anna
hkoira	koira	!h-koira
marko	Marko	!marko
keski-ranska	keski-Ranska	!keski-ranska
kerros-talo	kerrostalo	!kerros- talo	!kerros -talo
kuormaauto	kuorma-auto	kuorma auto
ras'an	raa'an	!raa’an
ras’an	raa’an	!raa'an
kuorma-audo	kuorma-auto	!kuorma‐auto
kuorma‐audo	kuorma‐auto	!kuorma-auto

[ignore_dot=1]
koirra.	koira.	!koira

[ocr_suggestions=1]
Män_sälä	Mäntsälä
horrelioosi	borrelioosi
baapa	haapa
h0usut	housut

[ocr_suggestions=1 ignore_numbers=1]
h0usut	!housut

